0 0 0 0 0 0 0 0 0 0 0 0 0 0 0 0 
0 0 0 0 0 0 0 0 0 0 0 0 0 0 0 0 
0 0 0 0 0 0 0 0 0 0 0 0 0 0 0 0 
0 0 4 5 6 7 0 0 0 13 14 15 0 0 20 21 
1 2 3 0 0 8 9 10 11 12 0 16 17 18 19 22 
0 0 0 0 0 0 0 0 0 0 0 0 0 0 0 23 
0 0 0 0 0 0 0 0 0 0 0 0 0 0 0 24 
0 0 0 0 0 0 0 0 0 0 0 0 0 0 0 25 
41 40 39 38 37 36 35 34 33 32 31 30 29 28 27 26 
