0 0 0 0 0 0 0 42 0 0 0 0 0 0 0 0 
0 0 0 0 38 39 40 41 0 17 16 15 14 13 0 0 
0 0 35 36 37 0 0 0 19 18 0 0 0 12 0 0 
0 0 34 0 0 0 0 0 20 0 0 0 0 11 0 0 
0 0 33 0 0 0 0 22 21 0 0 0 0 10 0 0 
0 0 32 0 0 0 0 23 0 0 0 0 0 9 0 0 
0 0 31 0 0 0 25 24 0 0 0 6 7 8 0 0 
0 0 30 29 28 27 26 0 2 3 4 5 0 0 0 0 
0 0 0 0 0 0 0 0 1 0 0 0 0 0 0 0 
