0 0 0 0 0 0 0 0 0 0 0 34 35 0 0 0 
0 0 0 0 0 0 0 0 0 19 20 33 36 0 0 0 
0 0 0 0 0 0 0 0 0 18 21 32 37 0 0 0 
0 0 0 0 0 0 8 9 10 17 22 31 38 0 0 0 
1 2 3 4 5 6 7 0 11 16 23 30 39 48 49 50 
0 0 0 0 0 0 0 0 12 15 24 29 40 47 0 0 
0 0 0 0 0 0 0 0 13 14 25 28 41 46 0 0 
0 0 0 0 0 0 0 0 0 0 26 27 42 45 0 0 
0 0 0 0 0 0 0 0 0 0 0 0 43 44 0 0 
