0 0 0 0 0 0 0 0 0 0 0 0 0 0 0 0 
0 0 0 0 0 0 0 0 0 13 14 27 28 0 0 0 
0 0 0 0 0 0 0 0 11 12 15 26 29 0 0 0 
0 0 0 0 0 0 8 9 10 0 16 25 30 0 0 0 
1 2 3 4 5 6 7 0 0 0 17 24 31 34 35 36 
0 0 0 0 0 0 0 0 0 0 18 23 32 33 0 0 
0 0 0 0 0 0 0 0 0 0 19 22 0 0 0 0 
0 0 0 0 0 0 0 0 0 0 20 21 0 0 0 0 
0 0 0 0 0 0 0 0 0 0 0 0 0 0 0 0 
