0 0 0 0 0 0 0 0 0 0 0 0 0 0 0 0 
0 0 0 0 0 0 0 0 0 15 16 0 0 0 0 0 
0 0 0 0 0 0 0 0 0 14 17 0 0 0 0 0 
0 0 0 0 0 0 0 0 0 13 18 0 0 0 0 0 
1 2 3 4 5 6 7 8 11 12 19 26 27 28 29 30 
0 0 0 0 0 0 0 9 10 0 20 25 0 0 0 0 
0 0 0 0 0 0 0 0 0 0 21 24 0 0 0 0 
0 0 0 0 0 0 0 0 0 0 22 23 0 0 0 0 
0 0 0 0 0 0 0 0 0 0 0 0 0 0 0 0 
