0 0 0 0 0 0 0 0 0 0 0 0 0 0 0 0 
0 0 0 0 0 0 0 0 0 0 0 0 0 0 0 0 
0 0 0 0 0 0 0 0 0 0 0 0 0 0 0 0 
0 0 0 0 0 0 8 9 0 0 0 0 0 0 0 0 
1 2 3 4 5 6 7 10 0 0 0 0 0 24 25 26 
0 0 0 0 0 0 0 11 12 13 0 0 0 23 0 0 
0 0 0 0 0 0 0 0 0 14 15 0 0 22 0 0 
0 0 0 0 0 0 0 0 0 0 16 17 18 21 0 0 
0 0 0 0 0 0 0 0 0 0 0 0 19 20 0 0 
