0 0 0 0 0 0 0 1 0 0 0 0 0 0 0 0 
0 0 0 0 0 0 0 2 0 0 0 0 0 0 0 0 
0 9 8 7 6 5 4 3 0 0 0 0 0 0 0 0 
0 10 0 0 0 0 0 0 0 0 0 26 27 28 29 30 
0 11 0 0 0 0 0 0 0 0 0 25 0 0 0 0 
0 12 0 0 0 0 0 0 0 0 0 24 0 0 0 0 
0 13 14 15 16 17 18 19 20 21 22 23 0 0 0 0 
0 0 0 0 0 0 0 0 0 0 0 0 0 0 0 0 
0 0 0 0 0 0 0 0 0 0 0 0 0 0 0 0 
