0 0 0 0 0 0 0 0 0 0 0 0 0 0 0 0 
0 0 0 0 0 0 0 0 0 0 0 0 0 0 0 0 
0 0 5 6 7 8 0 0 0 0 0 0 0 0 0 0 
0 0 4 0 0 9 0 0 0 0 0 0 0 0 0 0 
1 2 3 0 0 10 0 0 17 18 19 20 21 22 23 24 
0 0 0 0 0 11 0 0 16 0 0 0 0 0 0 0 
0 0 0 0 0 12 13 14 15 0 0 0 0 0 0 0 
0 0 0 0 0 0 0 0 0 0 0 0 0 0 0 0 
0 0 0 0 0 0 0 0 0 0 0 0 0 0 0 0 
