0 0 0 0 0 0 0 1 0 0 0 0 0 0 0 0 
0 0 0 0 5 4 3 2 0 26 27 28 29 30 0 0 
0 0 8 7 6 0 0 0 24 25 0 0 0 31 0 0 
0 0 9 0 0 0 0 0 23 0 0 0 0 32 0 0 
0 0 10 0 0 0 0 21 22 0 0 0 0 33 0 0 
0 0 11 0 0 0 0 20 0 0 0 0 0 34 0 0 
0 0 12 0 0 0 18 19 0 0 0 37 36 35 0 0 
0 0 13 14 15 16 17 0 41 40 39 38 0 0 0 0 
0 0 0 0 0 0 0 0 42 0 0 0 0 0 0 0 
