0 0 0 0 0 0 0 0 0 0 0 0 0 0 0 0 
0 0 6 7 8 9 10 0 0 0 0 0 0 0 0 0 
0 0 5 0 0 0 11 0 0 0 0 0 0 0 0 0 
0 0 4 0 0 0 12 0 0 0 0 0 0 0 0 0 
1 2 3 0 0 0 13 0 0 0 23 24 25 26 27 28 
0 0 0 0 0 0 14 0 0 0 22 0 0 0 0 0 
0 0 0 0 0 0 15 0 0 0 21 0 0 0 0 0 
0 0 0 0 0 0 16 17 18 19 20 0 0 0 0 0 
0 0 0 0 0 0 0 0 0 0 0 0 0 0 0 0 
