0 0 0 0 0 0 0 0 0 0 0 0 0 0 0 0 
0 0 0 0 0 0 0 0 0 0 0 0 0 0 0 0 
0 0 0 0 0 0 0 0 0 0 0 0 0 0 0 0 
0 0 4 5 6 7 0 0 0 0 0 0 0 0 0 0 
1 2 3 0 0 8 0 0 0 16 17 18 0 0 0 0 
0 0 0 0 0 9 0 0 0 15 0 19 20 21 22 23 
0 0 0 0 0 10 11 12 13 14 0 0 0 0 0 0 
0 0 0 0 0 0 0 0 0 0 0 0 0 0 0 0 
0 0 0 0 0 0 0 0 0 0 0 0 0 0 0 0 
